####################
#   ####           #
#                  #
#        #######    #
#                  #
####################

