####################
#  #####           #
#                  #
#    #######       #
#       ###        #
####################
