####################
#   ####    ####   #
#       ####       #
#   ###########    #
#   ###     ###    #
####################
