####################
#   ##             #
#     ####         #
#         #####    #
#            ##    #
####################